City/Town,Ward,Pct,"Janice L. Peaslee",Write-Ins,Blanks,"Total Votes Cast"
,,,
Bloomfield,,,10,0,0,10
Brunswick,,,9,0,0,9
Concord,,,26,1,0,27
Granby,,,18,0,0,18
Guildhall,,,22,1,0,23
Kirby,,,22,0,0,22
Lunenburg,,,33,1,0,34
Maidstone,,,7,2,0,9
Victory,,,3,0,0,3
TOTALS,,,150,5,0,155
