City/Town,Ward,Pct,"Matt Dunne","John Patrick Tracy",Write-Ins,Blanks,"Total Votes Cast"
,,,,
Addison,,,27,24,4,0,55
Albany,,,13,11,1,0,25
Alburgh,,,26,28,15,0,69
Andover,,,32,8,0,0,40
Arlington,,,41,38,0,0,79
Athens,,,10,7,0,0,17
Bakersfield,,,29,24,3,0,56
Baltimore,,,8,7,1,0,16
Barnard,,,67,4,5,0,76
Barnet,,,46,34,2,0,82
"Barre City",-,"Washington 3-1",117,56,12,0,185
"Barre City",-,"Washington 3-2",71,54,8,0,133
"Barre City",-,"Washington 3-3",14,12,2,0,28
"Barre Town",,,145,118,47,0,310
Barton,,,41,35,19,0,95
Belvidere,,,2,5,0,0,7
Bennington,-,"Bennington 2-1",130,85,9,0,224
Bennington,-,"Bennington 2-1 Nb",37,21,0,0,58
Bennington,-,"Bennington 2-2",130,110,8,0,248
Bennington,-,"Bennington 5",1,1,0,0,2
Benson,,,17,18,0,0,35
Berkshire,,,20,25,1,0,46
Berlin,,,65,59,2,0,126
Bethel,,,116,21,0,0,137
Bloomfield,,,3,6,0,0,9
Bolton,,,29,32,3,0,64
Bradford,,,88,45,9,0,142
Braintree,,,44,15,2,0,61
Brandon,,,117,81,4,0,202
Brattleboro,-,"Windham 3-1",213,52,3,0,268
Brattleboro,-,"Windham 3-2",214,77,1,0,292
Brattleboro,-,"Windham 3-3",224,51,4,0,279
Bridgewater,,,56,14,2,0,72
Bridport,,,43,25,1,0,69
Brighton,,,45,37,0,0,82
Bristol,,,100,73,6,0,179
Brookfield,,,50,12,3,0,65
Brookline,,,24,8,0,0,32
Brownington,,,24,1,0,0,25
Brunswick,,,4,2,2,0,8
Burke,,,20,17,1,0,38
Burlington,-,"Chittenden 3-1",186,571,10,0,767
Burlington,-,"Chittenden 3-2",112,304,8,0,424
Burlington,-,"Chittenden 3-3",161,427,5,0,593
Burlington,-,"Chittenden 3-4",153,203,3,0,359
Burlington,-,"Chittenden 3-5",407,730,6,0,"1,143"
Burlington,-,"Chittenden 3-6",45,78,0,0,123
Cabot,,,35,30,0,0,65
Calais,,,121,68,0,0,189
Cambridge,,,44,43,8,0,95
Canaan,,,23,15,1,0,39
Castleton,,,37,27,1,0,65
Cavendish,,,84,13,1,0,98
Charleston,,,18,7,0,0,25
Charlotte,,,190,267,1,0,458
Chelsea,,,57,14,2,0,73
Chester,,,218,36,2,0,256
Chittenden,,,22,18,0,0,40
Clarendon,,,35,35,2,0,72
Colchester,-,"Chittenden 7-1",64,159,10,0,233
Colchester,-,"Chittenden 7-2",103,265,8,0,376
Concord,,,21,18,3,0,42
Corinth,,,74,24,2,0,100
Cornwall,,,65,43,1,0,109
Coventry,,,17,17,3,0,37
Craftsbury,,,58,21,5,0,84
Danby,,,49,51,4,0,104
Danville,,,62,32,2,0,96
Derby,,,90,51,24,0,165
Dorset,,,53,29,1,0,83
Dover,,,20,9,0,0,29
Dummerston,,,211,34,7,0,252
Duxbury,,,40,28,0,0,68
"E. Haven",,,9,8,1,0,18
"E. Montpelier",,,96,61,5,0,162
Eden,,,21,23,8,0,52
Elmore,,,33,22,7,0,62
Enosburgh,,,29,51,3,0,83
Essex,-,"Chittenden 6-1",88,126,3,0,217
Essex,-,"Chittenden 6-2",160,173,5,0,338
Essex,-,"Chittenden 6-3",47,47,3,0,97
"Fair Haven",,,24,18,2,0,44
Fairfax,,,37,64,8,0,109
Fairfield,,,27,46,22,0,95
Fairlee,,,44,20,2,0,66
Fayston,,,26,22,0,0,48
Ferrisburgh,,,84,60,4,0,148
Fletcher,,,22,21,0,0,43
Franklin,,,26,32,5,0,63
Georgia,,,33,70,7,0,110
Glover,,,27,16,7,0,50
Goshen,,,7,4,3,0,14
Grafton,,,28,15,1,0,44
Granby,,,3,0,0,0,3
"Grand Isle",,,35,64,22,0,121
Granville,,,11,4,0,0,15
Greensboro,,,66,13,0,0,79
Groton,,,25,5,4,0,34
Guildhall,,,2,1,0,0,3
Guilford,,,109,27,1,0,137
Halifax,,,22,4,2,0,28
Hancock,,,12,3,2,0,17
Hardwick,,,77,63,15,0,155
Hartford,-,"Windsor 6-1",98,15,0,0,113
Hartford,-,"Windsor 6-2",377,29,5,0,411
Hartland,,,493,23,1,0,517
Highgate,,,39,43,31,0,113
Hinesburg,-,"Chittenden 1-1",121,131,1,0,253
Hinesburg,-,"Chittenden 1-2",8,2,0,0,10
Holland,,,5,5,5,0,15
Hubbardton,,,12,2,1,0,15
Huntington,,,84,81,1,0,166
"Hyde Park",,,80,23,4,0,107
Ira,-,"Rutland Rutland 1-1",0,1,0,0,1
Ira,-,"Rutland Rutland 1-2",11,9,0,0,20
Irasburg,,,18,6,5,0,29
"Isle La Motte",,,14,28,3,0,45
Jamaica,,,36,9,0,0,45
Jay,,,8,5,2,0,15
Jericho,,,108,182,3,0,293
Johnson,,,24,31,3,0,58
Killington,,,19,11,0,0,30
Kirby,,,9,12,1,0,22
Landgrove,,,11,12,0,0,23
Leicester,,,29,25,4,0,58
Lemington,,,2,2,1,0,5
Lincoln,,,70,43,3,0,116
Londonderry,,,42,20,1,0,63
Lowell,,,19,9,8,0,36
Ludlow,,,241,47,3,0,291
Lunenburg,,,24,27,13,0,64
Lyndon,,,74,50,7,0,131
Maidstone,,,2,4,0,0,6
Manchester,,,110,32,0,0,142
Marlboro,,,82,22,1,0,105
Marshfield,,,52,11,4,0,67
Mendon,,,18,29,0,0,47
Middlebury,,,270,149,3,0,422
Middlesex,,,93,40,0,0,133
"Middletown Springs",,,49,19,3,0,71
Milton,-,"Chittenden 9",89,170,4,0,263
Milton,-,"Grand Isle-Chittenden 1-1",15,20,0,0,35
Monkton,,,35,31,0,0,66
Montgomery,,,12,25,7,0,44
Montpelier,,,599,214,1,0,814
Moretown,,,73,59,0,0,132
Morgan,,,17,13,4,0,34
Morristown,,,137,115,13,0,265
"Mount Holly",,,74,53,8,0,135
"Mount Tabor",,,7,7,0,0,14
"New Haven",,,57,56,2,0,115
Newark,,,13,4,1,0,18
Newbury,-,"Center Town House",38,26,2,0,66
Newbury,-,"Town Office",14,15,0,0,29
Newbury,-,"West River Village",8,11,1,0,20
Newfane,,,128,51,3,0,182
"Newport City",,,74,67,14,0,155
"Newport Town",,,32,23,1,0,56
"N. Hero",,,14,22,3,0,39
Northfield,,,108,113,8,0,229
Norton,,,0,3,2,0,5
Norwich,,,809,70,2,0,881
Orange,,,9,7,5,0,21
Orwell,,,27,18,5,0,50
Panton,,,16,19,2,0,37
Pawlet,,,34,18,4,0,56
Peacham,,,50,10,0,0,60
Peru,,,26,7,0,0,33
Pittsfield,,,16,10,0,0,26
Pittsford,,,43,41,2,0,86
Plainfield,,,64,28,0,0,92
Plymouth,,,40,5,0,0,45
Pomfret,,,83,15,1,0,99
Poultney,,,46,41,4,0,91
Pownal,,,92,37,0,0,129
Proctor,,,29,22,2,0,53
Putney,,,336,52,1,0,389
Randolph,,,210,57,11,0,278
Reading,,,48,24,0,0,72
Readsboro,,,21,24,0,0,45
Richford,,,34,53,4,0,91
Richmond,,,160,171,5,0,336
Ripton,,,50,12,0,0,62
Rochester,,,85,21,4,0,110
Rockingham,,,332,105,12,0,449
Roxbury,,,28,9,0,0,37
Royalton,,,130,13,1,0,144
Rupert,,,20,25,0,0,45
"Rutland City",-,"Rutland 5-1",102,66,3,0,171
"Rutland City",-,"Rutland 5-2",79,66,1,0,146
"Rutland City",-,"Rutland 5-3",48,44,3,0,95
"Rutland City",-,"Rutland 5-4",82,89,2,0,173
"Rutland Town",-,"Elem. School",55,59,1,0,115
"Rutland Town",-,"Town Hall",22,19,0,0,41
Ryegate,,,21,23,1,0,45
Salisbury,,,33,23,1,0,57
Sandgate,,,23,11,0,0,34
Searsburg,,,1,1,0,0,2
Shaftsbury,,,137,91,4,0,232
Sharon,,,124,12,4,0,140
Sheffield,,,15,7,5,0,27
Shelburne,-,"Chittenden 5-1",242,144,13,0,399
Shelburne,-,"Chittenden 5-2",119,113,6,0,238
Sheldon,,,23,20,16,0,59
Shoreham,,,34,19,1,0,54
Shrewsbury,,,49,16,0,0,65
"S. Burlington",-,"Chittenden 3-10",76,173,0,0,249
"S. Burlington",-,"Chittenden 3-7",125,214,2,0,341
"S. Burlington",-,"Chittenden 3-8",114,259,6,0,379
"S. Burlington",-,"Chittenden 3-9",85,184,5,0,274
"S. Hero",,,59,71,12,0,142
Springfield,-,"Windsor 1-1",4,3,0,0,7
Springfield,-,"Windsor 1-2",319,251,1,0,571
"St. Albans City",,,107,169,67,0,343
"St. Albans Town",,,83,101,27,0,211
"St. George",,,17,18,0,0,35
"St. Johnsbury",,,103,65,10,0,178
Stamford,,,19,14,0,0,33
Stannard,,,9,13,0,0,22
Starksboro,,,70,25,0,0,95
Stockbridge,,,35,6,0,0,41
Stowe,,,94,81,4,0,179
Strafford,,,196,12,0,0,208
Stratton,,,3,5,0,0,8
Sudbury,,,23,17,0,0,40
Sunderland,,,20,9,4,0,33
Sutton,,,17,9,1,0,27
Swanton,,,91,158,40,0,289
Thetford,,,343,36,2,0,381
Tinmouth,,,17,20,0,0,37
Topsham,,,15,2,1,0,18
Townshend,,,61,24,2,0,87
Troy,,,20,23,3,0,46
Tunbridge,,,58,16,0,0,74
Underhill,,,78,120,5,0,203
Vergennes,,,51,59,13,0,123
Vernon,,,55,19,4,0,78
Vershire,,,43,10,1,0,54
Victory,,,1,1,0,0,2
Waitsfield,,,46,58,1,0,105
Walden,,,43,12,0,0,55
Wallingford,,,56,56,1,0,113
Waltham,,,12,12,4,0,28
Wardsboro,,,26,9,0,0,35
Warren,,,38,38,4,0,80
Washington,,,30,20,2,0,52
Waterbury,,,96,117,4,0,217
Waterford,,,18,11,1,0,30
Waterville,,,8,8,2,0,18
Weathersfield,,,136,36,3,0,175
Wells,,,16,17,0,0,33
"W. Fairlee",,,24,12,1,0,37
"W. Haven",,,4,3,1,0,8
"W. Rutland",,,20,19,1,0,40
"W. Windsor",,,123,11,1,0,135
Westfield,,,12,5,4,0,21
Westford,,,32,62,3,0,97
Westminster,-,"Windham 4",16,3,0,0,19
Westminster,-,"Windham 5",283,53,1,0,337
Westmore,,,12,4,0,0,16
Weston,,,46,21,0,0,67
Weybridge,,,63,19,2,0,84
Wheelock,,,13,7,1,0,21
Whiting,,,29,7,6,0,42
Whitingham,,,17,23,0,0,40
Williamstown,,,47,29,8,0,84
Williston,,,235,299,3,0,537
Wilmington,,,48,23,1,0,72
Windham,,,20,8,2,0,30
Windsor,,,264,27,2,0,293
Winhall,,,26,11,0,0,37
Winooski,,,104,209,6,0,319
Wolcott,,,30,39,8,0,77
Woodbury,,,61,36,6,0,103
Woodford,,,6,10,0,0,16
Woodstock,,,417,28,2,0,447
Worcester,,,90,31,4,0,125
TOTALS,,,"19,929","13,707","1,054",0,"34,690"
