City/Town,Ward,Pct,"No Nomination",Write-Ins,Blanks,Spoiled,"Total Votes Cast"
,,
Arlington,,,-,0,1,0,1
Bakersfield,,,-,4,1,0,5
"Barre City",,,-,0,3,0,3
"Barre Town",,,-,5,1,0,6
Barton,,,-,1,0,0,1
Belvidere,,,-,0,1,0,1
Bennington,-,"Bennington 2-1",-,1,8,0,9
Bennington,-,"Bennington 2-2",-,2,4,0,6
Benson,,,-,0,1,0,1
Berlin,,,-,3,3,0,6
Bethel,,,-,2,4,0,6
Bolton,,,-,0,1,0,1
Bradford,,,-,0,1,0,1
Braintree,,,-,1,1,0,2
Brandon,,,-,0,1,0,1
Brattleboro,-,"Windham 2-1",-,1,0,0,1
Brattleboro,-,"Windham 2-2",-,2,1,0,3
Brattleboro,-,"Windham 2-3",-,7,4,0,11
Bridgewater,,,-,0,1,0,1
Bridport,,,-,0,3,0,3
Bristol,,,-,0,1,0,1
Brookfield,,,-,0,2,0,2
Burke,,,-,0,0,1,1
Burlington,-,"Chittenden 6-1",-,0,3,0,3
Burlington,-,"Chittenden 6-2",-,9,4,0,13
Burlington,-,"Chittenden 6-3",-,14,4,0,18
Burlington,-,"Chittenden 6-4",-,7,1,0,8
Burlington,-,"Chittenden 6-5",-,4,7,0,11
Burlington,-,"Chittenden 6-6",-,2,0,0,2
Burlington,-,"Chittenden 6-7",-,0,0,0,0
Cabot,,,-,1,1,0,2
Calais,,,-,3,1,0,4
Cambridge,,,-,2,2,0,4
Canaan,,,-,0,1,0,1
Castleton,,,-,0,5,0,5
Cavendish,,,-,0,1,0,1
Charleston,,,-,3,1,0,4
Charlotte,,,-,0,4,0,4
Chester,,,-,0,2,0,2
Clarendon,,,-,0,3,0,3
Colchester,-,"Chittenden 9-1",-,1,2,2,5
Colchester,-,"Chittenden 9-2",-,2,1,0,3
Corinth,,,-,1,1,0,2
Coventry,,,-,1,1,0,2
Craftsbury,,,-,1,0,0,1
Danby,,,-,0,2,0,2
Derby,,,-,0,2,0,2
Dorset,,,-,0,5,0,5
Dover,,,-,1,0,0,1
Dummerston,,,-,3,1,0,4
Duxbury,,,-,0,1,0,1
"E. Montpelier",,,-,0,1,0,1
Eden,,,-,2,1,0,3
Elmore,,,-,0,1,0,1
Enosburgh,,,-,11,2,0,13
Essex,-,"Chittenden 8-1",-,0,1,0,1
Essex,-,"Chittenden 8-2",-,2,1,0,3
Essex,-,"Chittenden 8-3",-,0,0,0,0
"Fair Haven",,,-,0,2,0,2
Fairfax,,,-,1,0,0,1
Fairfield,,,-,1,0,0,1
Fairlee,,,-,0,1,0,1
Fayston,,,-,1,1,0,2
Ferrisburgh,,,-,1,2,0,3
Fletcher,,,-,2,0,0,2
Franklin,,,-,6,0,0,6
Georgia,,,-,1,1,0,2
Glover,,,-,0,2,0,2
Goshen,,,-,0,1,0,1
"Grand Isle",,,-,1,3,0,4
Groton,,,-,1,3,0,4
Guilford,,,-,3,3,0,6
Halifax,,,-,0,4,0,4
Hardwick,,,-,4,2,0,6
Hartford,-,"Windsor 4-1",-,0,2,0,2
Hartford,-,"Windsor 4-2",-,0,2,0,2
Highgate,,,-,1,3,0,4
Hinesburg,-,"Chittenden 4-1",-,0,0,0,0
Hinesburg,-,"Chittenden 4-2",-,1,0,0,1
Huntington,,,-,1,3,0,4
"Hyde Park",,,-,1,1,0,2
Irasburg,,,-,0,1,0,1
"Isle La Motte",,,-,1,3,0,4
Jamaica,,,-,0,1,0,1
Jericho,,,-,1,1,0,2
Landgrove,,,-,0,1,0,1
Leicester,,,-,1,0,0,1
Londonderry,,,-,0,1,0,1
Lowell,,,-,1,0,0,1
Lunenburg,,,-,0,1,0,1
Lyndon,,,-,1,3,0,4
Marshfield,,,-,4,2,0,6
Middlebury,,,-,1,0,0,1
Middlesex,,,-,4,1,0,5
"Middletown Springs",,,-,1,4,0,5
Milton,-,"Chittenden 10",-,5,0,0,5
Milton,-,"Grand Isle-Chittenden",-,0,0,0,0
Monkton,,,-,1,0,0,1
Montgomery,,,-,7,0,0,7
Montpelier,,,-,8,4,0,12
Moretown,,,-,1,2,0,3
Morgan,,,-,0,1,0,1
Morristown,,,-,4,3,0,7
"New Haven",,,-,1,1,0,2
Newark,,,-,1,0,0,1
Newbury,,,-,0,5,0,5
Newfane,,,-,1,1,0,2
"Newport City",,,-,1,1,0,2
"Newport Town",,,-,2,1,0,3
Northfield,,,-,7,1,0,8
Norwich,,,-,4,1,0,5
Peacham,,,-,0,1,0,1
Pittsfield,,,-,1,0,0,1
Pittsford,,,-,0,4,0,4
Plainfield,,,-,4,0,0,4
Pomfret,,,-,2,1,0,3
Pownal,,,-,1,0,0,1
Proctor,,,-,0,1,0,1
Putney,,,-,2,3,0,5
Randolph,,,-,1,3,0,4
Readsboro,,,-,0,1,0,1
Richford,,,-,3,1,0,4
Richmond,,,-,1,3,0,4
Rochester,,,-,3,1,0,4
Rockingham,,,-,1,2,0,3
Royalton,,,-,0,1,0,1
Rupert,,,-,0,1,0,1
"Rutland City",-,"Rutland 5-1",-,0,0,0,0
"Rutland City",-,"Rutland 5-2",-,0,0,1,1
"Rutland City",-,"Rutland 5-3",-,0,0,1,1
"Rutland City",-,"Rutland 5-4",-,0,1,1,2
"Rutland Town",,,-,0,6,0,6
Ryegate,,,-,2,0,0,2
Salisbury,,,-,1,2,0,3
Shaftsbury,,,-,0,2,0,2
Sharon,,,-,1,0,0,1
Sheffield,,,-,1,0,0,1
Shelburne,-,"Chittenden 5-1",-,2,3,0,5
Shelburne,-,"Chittenden 5-2",-,1,0,0,1
Sheldon,,,-,2,1,0,3
"S. Burlington",-,"Chittenden 7-1",-,0,1,1,2
"S. Burlington",-,"Chittenden 7-2",-,1,0,0,1
"S. Burlington",-,"Chittenden 7-3",-,3,3,0,6
"S. Burlington",-,"Chittenden 7-4",-,1,3,0,4
"S. Hero",,,-,1,2,0,3
Springfield,-,"Windsor 3-1",-,0,0,0,0
Springfield,-,"Windsor 3-2",-,0,1,0,1
"St. Albans City",,,-,10,0,8,18
"St. Albans Town",-,"Franklin 3-1",-,1,0,0,1
"St. Albans Town",-,"Franklin 3-2",-,1,1,0,2
"St. Johnsbury",,,-,3,2,0,5
Stockbridge,,,-,0,2,0,2
Sudbury,,,-,0,0,1,1
Swanton,,,-,1,1,0,2
Thetford,,,-,0,1,0,1
Tinmouth,-,"Rutland 2",-,0,0,0,0
Tinmouth,-,Rutland-Bennington,-,0,2,0,2
Troy,-,"Orleans 2",-,1,1,0,2
Troy,-,Orleans-Lamoille,-,0,2,0,2
Tunbridge,,,-,3,2,0,5
Underhill,,,-,5,0,0,5
Vergennes,,,-,2,3,0,5
Vernon,,,-,0,2,0,2
Vershire,,,-,0,2,0,2
Waitsfield,,,-,1,0,0,1
Walden,,,-,0,5,0,5
Wallingford,,,-,2,1,0,3
Warren,,,-,0,0,1,1
Washington,,,-,1,1,0,2
Waterbury,,,-,2,0,0,2
Weathersfield,,,-,1,2,0,3
Wells,,,-,1,1,0,2
"W. Rutland",,,-,2,0,0,2
Westford,,,-,1,1,0,2
Westminster,-,"Windham 3",-,0,0,0,0
Westminster,-,"Windham 4",-,2,0,1,3
Weybridge,,,-,0,2,0,2
Wheelock,,,-,0,1,0,1
Williamstown,,,-,2,1,0,3
Williston,,,-,3,1,0,4
Windham,,,-,0,1,0,1
Windsor,,,-,1,0,0,1
Winhall,,,-,0,2,0,2
Winooski,,,-,4,8,0,12
Wolcott,,,-,1,1,0,2
Woodstock,,,-,3,2,0,5
Worcester,,,-,0,5,0,5
TOTALS,,,-,272,286,18,576
