City/Town,Ward,Pct,"David Zuckerman","Boots Wardinski",Write-Ins,Blanks,Spoiled,"Total Votes Cast"
,,,,
Arlington,,,0,0,0,1,0,1
Bakersfield,,,2,1,2,0,0,5
"Barre City",,,1,2,0,0,0,3
"Barre Town",,,4,0,2,0,0,6
Barton,,,1,0,0,0,0,1
Belvidere,,,0,0,0,1,0,1
Bennington,-,"Bennington 2-1",2,3,0,4,0,9
Bennington,-,"Bennington 2-2",2,2,0,2,0,6
Benson,,,0,1,0,0,0,1
Berlin,,,4,1,0,1,0,6
Bethel,,,4,0,0,2,0,6
Bolton,,,0,0,0,1,0,1
Bradford,,,0,1,0,0,0,1
Braintree,,,0,0,1,1,0,2
Brandon,,,0,1,0,0,0,1
Brattleboro,-,"Windham 2-1",0,1,0,0,1
Brattleboro,-,"Windham 2-2",2,1,0,0,0,3
Brattleboro,-,"Windham 2-3",7,3,0,1,0,11
Bridgewater,,,0,0,0,1,0,1
Bridport,,,0,0,0,3,0,3
Bristol,,,0,1,0,0,0,1
Brookfield,,,0,1,0,1,0,2
Burke,,,0,0,0,0,1,1
Burlington,-,"Chittenden 6-1",2,1,0,0,3
Burlington,-,"Chittenden 6-2",11,1,0,1,0,13
Burlington,-,"Chittenden 6-3",13,3,1,1,0,18
Burlington,-,"Chittenden 6-4",7,0,0,1,0,8
Burlington,-,"Chittenden 6-5",9,2,0,0,0,11
Burlington,-,"Chittenden 6-6",2,0,0,0,2
Burlington,-,"Chittenden 6-7",0,0,0,0,0
Cabot,,,2,0,0,0,0,2
Calais,,,4,0,0,0,0,4
Cambridge,,,0,0,2,2,0,4
Canaan,,,0,0,0,1,0,1
Castleton,,,0,2,0,3,0,5
Cavendish,,,0,1,0,0,0,1
Charleston,,,1,3,0,0,0,4
Charlotte,,,2,0,0,2,0,4
Chester,,,0,1,0,1,0,2
Clarendon,,,0,1,0,2,0,3
Colchester,-,"Chittenden 9-1",2,1,0,1,1,5
Colchester,-,"Chittenden 9-2",2,0,1,0,0,3
Corinth,,,0,2,0,0,0,2
Coventry,,,0,0,1,1,0,2
Craftsbury,,,1,0,0,0,0,1
Danby,,,0,1,0,1,0,2
Derby,,,1,0,0,1,0,2
Dorset,,,0,1,0,4,0,5
Dover,,,0,1,0,0,0,1
Dummerston,,,0,3,0,1,0,4
Duxbury,,,0,0,1,0,0,1
"E. Montpelier",,,0,1,0,0,0,1
Eden,,,1,0,2,0,0,3
Elmore,,,0,0,0,1,0,1
Enosburgh,,,10,0,2,1,0,13
Essex,-,"Chittenden 8-1",0,0,1,0,1
Essex,-,"Chittenden 8-2",0,1,1,0,3
Essex,-,"Chittenden 8-3",0,0,0,0,0
"Fair Haven",,,2,0,0,0,0,2
Fairfax,,,0,1,0,0,0,1
Fairfield,,,0,0,1,0,0,1
Fairlee,,,0,1,0,0,0,1
Fayston,,,0,1,1,0,0,2
Ferrisburgh,,,1,2,0,0,0,3
Fletcher,,,2,0,0,0,0,2
Franklin,,,3,1,1,1,0,6
Georgia,,,1,0,1,0,0,2
Glover,,,0,1,0,1,0,2
Goshen,,,0,1,0,0,0,1
"Grand Isle",,,3,0,0,1,0,4
Groton,,,0,1,0,3,0,4
Guilford,,,5,0,0,1,0,6
Halifax,,,0,1,0,3,0,4
Hardwick,,,6,0,0,0,0,6
Hartford,-,"Windsor 4-1",1,0,1,0,2
Hartford,-,"Windsor 4-2",1,0,1,0,2
Highgate,,,0,1,2,1,0,4
Hinesburg,-,"Chittenden 4-1",0,0,0,0,0
Hinesburg,-,"Chittenden 4-2",0,0,0,0,1
Huntington,,,1,0,0,3,0,4
"Hyde Park",,,0,0,1,1,0,2
Irasburg,,,0,0,0,1,0,1
"Isle La Motte",,,2,1,0,1,0,4
Jamaica,,,0,1,0,0,0,1
Jericho,,,1,1,0,0,0,2
Landgrove,,,1,0,0,0,0,1
Leicester,,,1,0,0,0,0,1
Londonderry,,,0,1,0,0,0,1
Lowell,,,1,0,0,0,0,1
Lunenburg,,,0,0,0,1,0,1
Lyndon,,,0,1,2,1,0,4
Marshfield,,,3,1,0,2,0,6
Middlebury,,,0,0,1,0,0,1
Middlesex,,,4,1,0,0,0,5
"Middletown Springs",,,3,0,1,1,0,5
Milton,-,"Chittenden 10",2,2,0,0,5
Milton,-,"Grand Isle-Chittenden",0,0,0,0,0
Monkton,,,1,0,0,0,0,1
Montgomery,,,7,0,0,0,0,7
Montpelier,,,9,2,0,1,0,12
Moretown,,,1,0,0,2,0,3
Morgan,,,0,0,0,1,0,1
Morristown,,,1,2,2,2,0,7
"New Haven",,,0,1,1,0,0,2
Newark,,,0,0,1,0,0,1
Newbury,,,0,4,0,1,0,5
Newfane,,,0,2,0,0,0,2
"Newport City",,,1,0,1,0,0,2
"Newport Town",,,1,0,1,1,0,3
Northfield,,,0,0,7,1,0,8
Norwich,,,5,0,0,0,0,5
Peacham,,,0,0,0,1,0,1
Pittsfield,,,1,0,0,0,0,1
Pittsford,,,0,3,0,1,0,4
Plainfield,,,4,0,0,0,0,4
Pomfret,,,0,1,1,1,0,3
Pownal,,,1,0,0,0,0,1
Proctor,,,0,0,1,0,0,1
Putney,,,1,2,0,2,0,5
Randolph,,,1,1,0,2,0,4
Readsboro,,,0,0,0,1,0,1
Richford,,,2,1,0,1,0,4
Richmond,,,0,1,1,2,0,4
Rochester,,,0,2,2,0,0,4
Rockingham,,,0,1,1,1,0,3
Royalton,,,0,0,1,0,0,1
Rupert,,,0,1,0,0,0,1
"Rutland City",-,"Rutland 5-1",0,0,0,0,0
"Rutland City",-,"Rutland 5-2",0,0,0,1,1
"Rutland City",-,"Rutland 5-3",0,0,0,1,1
"Rutland City",-,"Rutland 5-4",0,0,0,2,2
"Rutland Town",,,0,4,0,2,0,6
Ryegate,,,2,0,0,0,0,2
Salisbury,,,0,1,2,0,0,3
Shaftsbury,,,1,0,0,1,0,2
Sharon,,,1,0,0,0,0,1
Sheffield,,,1,0,0,0,0,1
Shelburne,-,"Chittenden 5-1",1,0,0,0,5
Shelburne,-,"Chittenden 5-2",1,0,0,0,1
Sheldon,,,1,1,1,0,0,3
"S. Burlington",-,"Chittenden 7-1",1,0,0,1,2
"S. Burlington",-,"Chittenden 7-2",1,0,0,0,0,1
"S. Burlington",-,"Chittenden 7-3",1,2,0,2,1,6
"S. Burlington",-,"Chittenden 7-4",2,0,2,0,4
"S. Hero",,,0,2,1,0,0,3
Springfield,-,"Windsor 3-1",0,0,0,0,0
Springfield,-,"Windsor 3-2",1,0,0,0,1
"St. Albans City",,,6,7,2,0,3,18
"St. Albans Town",-,"Franklin 3-1",0,1,0,0,1
"St. Albans Town",-,"Franklin 3-2",0,1,1,0,2
"St. Johnsbury",,,3,2,0,0,0,5
Stockbridge,,,0,1,0,1,0,2
Sudbury,,,0,1,0,0,0,1
Swanton,,,1,1,0,0,0,2
Thetford,,,0,1,0,0,0,1
Tinmouth,-,"Rutland 2",0,0,0,0,0
Tinmouth,-,Rutland-Bennington,1,0,1,0,2
Troy,-,"Orleans 2",0,0,0,0,2
Troy,-,Orleans-Lamoille,2,0,0,0,2
Tunbridge,,,4,0,0,1,0,5
Underhill,,,5,0,0,0,0,5
Vergennes,,,2,0,0,3,0,5
Vernon,,,0,0,0,2,0,2
Vershire,,,0,2,0,0,0,2
Waitsfield,,,0,0,1,0,0,1
Walden,,,1,3,0,1,0,5
Wallingford,,,0,2,0,1,0,3
Warren,,,1,0,0,0,0,1
Washington,,,0,2,0,0,0,2
Waterbury,,,1,0,1,0,0,2
Weathersfield,,,2,1,0,0,0,3
Wells,,,0,1,0,1,0,2
"W. Rutland",,,0,2,0,0,0,2
Westford,,,1,1,0,0,0,2
Westminster,-,"Windham 3",0,0,0,0,0
Westminster,-,"Windham 4",0,1,0,1,3
Weybridge,,,0,2,0,0,0,2
Wheelock,,,0,0,1,0,0,1
Williamstown,,,0,0,3,0,0,3
Williston,,,3,1,0,0,0,4
Windham,,,0,1,0,0,0,1
Windsor,,,1,0,0,0,0,1
Winhall,,,0,0,0,2,0,2
Winooski,,,6,4,0,2,0,12
Wolcott,,,0,0,2,0,0,2
Woodstock,,,0,3,2,0,0,5
Worcester,,,2,1,1,1,0,5
TOTALS,,,228,150,72,114,12,576
