City/Town,Ward,Pct,"Ed Flanagan","Robert Wolcott Backus",Write-Ins,Blanks,"Total Votes Cast"
,,,,
Addison,,,23,20,1,0,44
Albany,,,17,19,4,0,40
Alburgh,,,40,41,8,0,89
Andover,,,15,21,1,0,37
Arlington,,,39,56,0,0,95
Athens,,,6,11,0,0,17
Bakersfield,,,56,47,13,0,116
Baltimore,,,9,4,0,0,13
Barnard,,,29,14,3,0,46
Barnet,,,42,21,0,0,63
"Barre City",-,"Washington 4-1",92,66,4,0,162
"Barre City",-,"Washington 4-2",137,102,16,0,255
"Barre Town",,,203,148,51,0,402
Barton,-,"Barton Memorial",44,20,18,0,82
Barton,-,"Orleans Memorial",26,12,13,0,51
Belvidere,,,5,3,1,0,9
Bennington,-,"Bennington 2-1",47,77,0,0,124
Bennington,-,"Bennington 2-1 Nb",25,47,0,0,72
Bennington,-,"Bennington 2-2",25,17,2,0,44
Bennington,-,"Bennington 2-3",123,115,3,0,241
Bennington,-,"Bennington 2-4",1,2,0,0,3
Benson,,,19,17,1,0,37
Berkshire,,,61,58,5,0,124
Berlin,,,56,46,2,0,104
Bethel,,,76,43,7,0,126
Bloomfield,,,2,4,0,0,6
Bolton,,,32,44,11,0,87
Bradford,,,64,38,29,0,131
Braintree,,,27,47,4,0,78
Brandon,,,62,68,12,0,142
Brattleboro,-,"Windham 2-1",115,175,7,0,297
Brattleboro,-,"Windham 2-2",181,192,10,0,383
Brattleboro,-,"Windham 2-3",136,185,2,0,323
Bridgewater,,,13,23,6,0,42
Bridport,,,28,32,0,0,60
Brighton,,,53,29,3,0,85
Bristol,,,165,186,12,0,363
Brookfield,,,40,71,6,0,117
Brookline,,,10,15,2,0,27
Brownington,,,18,9,2,0,29
Brunswick,,,4,0,0,0,4
Burke,,,22,31,2,0,55
Burlington,-,"Chittenden 7-1 Ward 5",280,243,6,0,529
Burlington,-,"Chittenden 7-1 Ward 6",121,92,3,0,216
Burlington,-,"Chittenden 7-2 Ward 2",28,23,1,0,52
Burlington,-,"Chittenden 7-2 Ward 3",238,151,7,0,396
Burlington,-,"Chittenden 7-2 Ward 5",6,12,0,0,18
Burlington,-,"Chittenden 7-3 Ward 1",216,169,5,0,390
Burlington,-,"Chittenden 7-3 Ward 2",12,8,1,0,21
Burlington,-,"Chittenden 7-3 Ward 6",18,21,0,0,39
Burlington,-,"Chittenden 7-4 Ward 2",139,79,3,0,221
Burlington,-,"Chittenden 7-5 Ward 3",22,1,0,0,23
Burlington,-,"Chittenden 7-5 Ward 4",65,64,0,0,129
Burlington,-,"Chittenden 7-5 Ward 7",157,150,4,0,311
Burlington,-,"Chittenden 7-6 Ward 4",216,246,9,0,471
Burlington,-,"Chittenden 7-6 Ward 7",136,103,4,0,243
Burlington,-,"Chittenden 7-7 Ward 6",116,124,1,0,241
Cabot,,,28,28,1,0,57
Calais,,,73,68,1,0,142
Cambridge,,,56,50,7,0,113
Canaan,,,16,13,0,0,29
Castleton,,,42,70,3,0,115
Cavendish,,,23,31,0,0,54
Charleston,,,13,9,3,0,25
Charlotte,,,146,137,0,0,283
Chelsea,,,21,36,2,0,59
Chester,,,112,126,8,0,246
Chittenden,,,18,19,3,0,40
Clarendon,,,63,78,2,0,143
Colchester,-,"Chittenden 1-1",165,128,3,0,296
Colchester,-,"Chittenden 1-2",156,134,3,0,293
Colchester,-,"Chittenden 1-3",1,0,0,0,1
Concord,,,10,8,3,0,21
Corinth,,,53,57,2,0,112
Cornwall,,,43,41,1,0,85
Coventry,,,16,2,4,0,22
Craftsbury,,,25,48,12,0,85
Danby,,,23,18,4,0,45
Danville,,,41,32,5,0,78
Derby,,,75,69,52,0,196
Dorset,,,30,22,4,0,56
Dover,,,9,26,0,0,35
Dummerston,,,57,100,0,0,157
Duxbury,,,56,48,4,0,108
"E. Haven",,,8,8,0,0,16
"E. Montpelier",,,87,87,5,0,179
Eden,,,16,18,4,0,38
Elmore,,,42,17,5,0,64
Enosburgh,,,184,155,41,0,380
Essex,-,"Chittenden 2-1",169,194,11,0,374
Essex,-,"Chittenden 2-3",11,22,0,0,33
Essex,-,"Chittenden 2-4",230,234,13,0,477
"Fair Haven",,,40,28,2,0,70
Fairfax,,,80,70,4,0,154
Fairfield,,,52,40,20,0,112
Fairlee,,,29,19,2,0,50
Fayston,,,41,23,0,0,64
Ferrisburgh,,,55,59,2,0,116
Fletcher,,,40,23,3,0,66
Franklin,,,21,13,6,0,40
Georgia,,,77,62,3,0,142
Glover,,,25,24,10,0,59
Goshen,,,2,13,0,0,15
Grafton,,,30,46,2,0,78
Granby,,,1,2,0,0,3
"Grand Isle",,,97,62,10,0,169
Granville,,,10,5,0,0,15
Greensboro,,,13,22,4,0,39
Groton,,,16,10,1,0,27
Guildhall,,,2,4,1,0,7
Guilford,,,66,81,3,0,150
Halifax,,,8,21,3,0,32
Hancock,,,7,6,9,0,22
Hardwick,,,80,40,7,0,127
Hartford,-,"Windsor 2-1",69,46,3,0,118
Hartford,-,"Windsor 2-2",240,173,24,0,437
Hartland,,,123,91,9,0,223
Highgate,,,57,51,17,0,125
Hinesburg,,,149,169,14,0,332
Holland,,,9,8,2,0,19
Hubbardton,,,4,7,0,0,11
Huntington,,,136,83,2,0,221
"Hyde Park",,,62,49,17,0,128
Ira,,,6,8,0,0,14
Irasburg,,,15,11,9,0,35
"Isle La Motte",,,14,8,0,0,22
Jamaica,,,18,22,9,0,49
Jay,,,10,4,7,0,21
Jericho,,,157,185,3,0,345
Johnson,,,66,36,10,0,112
Kirby,,,10,10,2,0,22
Landgrove,,,5,3,0,0,8
Leicester,,,17,16,0,0,33
Lemington,,,2,1,0,0,3
Lincoln,,,71,107,3,0,181
Londonderry,,,18,44,5,0,67
Lowell,,,16,11,4,0,31
Ludlow,,,34,44,4,0,82
Lunenburg,-,"Comm. Hall",6,13,2,0,21
Lunenburg,-,Gilman,2,5,2,0,9
Lyndon,,,63,74,4,0,141
Maidstone,,,1,0,0,0,1
Manchester,,,62,44,0,0,106
Marlboro,,,57,58,2,0,117
Marshfield,,,58,47,3,0,108
Mendon,,,9,22,0,0,31
Middlebury,,,208,161,11,0,380
Middlesex,,,57,54,2,0,113
"Middletown Springs",,,58,71,0,0,129
Milton,-,"Chittenden 2-2",119,135,1,0,255
Milton,-,"Chittenden 2-3",33,28,0,0,61
Monkton,,,96,88,3,0,187
Montgomery,,,27,24,1,0,52
Montpelier,-,"Washington 5",366,409,13,0,788
Montpelier,-,"Washington-Lamoille 1-1",13,15,0,0,28
Moretown,,,67,67,5,0,139
Morgan,,,19,8,1,0,28
Morristown,,,65,74,17,0,156
"Mount Holly",,,48,29,0,0,77
"Mount Tabor",,,7,3,1,0,11
"New Haven",,,66,58,13,0,137
Newark,,,14,21,2,0,37
Newbury,-,"Center Town House",8,7,0,0,15
Newbury,-,"Town Office",43,32,3,0,78
Newbury,-,"West River Village",16,14,3,0,33
Newfane,,,69,86,2,0,157
"Newport City",,,92,66,21,0,179
"Newport Town",,,22,14,24,0,60
"N. Hero",,,24,16,0,0,40
Northfield,,,183,128,9,0,320
Norton,,,0,2,1,0,3
Norwich,,,397,263,10,0,670
Orange,,,17,16,3,0,36
Orwell,,,35,20,1,0,56
Panton,,,16,20,0,0,36
Pawlet,,,19,39,1,0,59
Peacham,,,23,34,2,0,59
Peru,,,6,13,3,0,22
Pittsfield,,,9,11,0,0,20
Pittsford,,,40,41,2,0,83
Plainfield,,,71,41,1,0,113
Plymouth,,,7,9,0,0,16
Pomfret,,,50,28,0,0,78
Poultney,,,99,101,3,0,203
Pownal,,,27,30,2,0,59
Proctor,,,76,74,0,0,150
Putney,,,116,146,4,0,266
Randolph,,,139,196,17,0,352
Reading,,,23,27,2,0,52
Readsboro,,,18,16,0,0,34
Richford,,,140,119,20,0,279
Richmond,,,132,150,3,0,285
Ripton,,,12,20,1,0,33
Rochester,,,42,41,10,0,93
Rockingham,,,336,392,128,0,856
Roxbury,,,20,24,0,0,44
Royalton,,,131,124,5,0,260
Rupert,,,21,20,1,0,42
"Rutland City",-,"Rutland 6-1 Ward 1",98,87,6,0,191
"Rutland City",-,"Rutland 6-2 Ward 2",51,65,1,0,117
"Rutland City",-,"Rutland 6-3 Ward 3a",88,77,7,0,172
"Rutland City",-,"Rutland 6-3 Ward 3b",46,29,2,0,77
"Rutland City",-,"Rutland 6-4 Ward 4",70,62,8,0,140
"Rutland Town",,,75,79,5,0,159
Ryegate,,,17,19,3,0,39
Salisbury,,,22,25,3,0,50
Sandgate,,,11,11,0,0,22
Searsburg,,,0,3,1,0,4
Shaftsbury,,,63,47,2,0,112
Sharon,,,45,50,1,0,96
Sheffield,,,11,10,3,0,24
Shelburne,-,"Chittenden 5-1",60,62,4,0,126
Shelburne,-,"Chittenden 5-3",13,14,2,0,29
Shelburne,-,"Chittenden 5-4",151,166,12,0,329
Sheldon,,,38,38,8,0,84
Sherburne,,,5,17,1,0,23
Shoreham,,,21,26,1,0,48
Shrewsbury,,,47,42,5,0,94
"S. Burlington",-,"Chittenden 7-10",135,147,6,0,288
"S. Burlington",-,"Chittenden 7-7",57,74,6,0,137
"S. Burlington",-,"Chittenden 7-8",178,166,3,0,347
"S. Burlington",-,"Chittenden 7-9",145,156,4,0,305
"S. Hero",,,53,53,4,0,110
Springfield,-,"Windsor 1-1",74,65,2,0,141
Springfield,-,"Windsor 6",209,211,16,0,436
"St. Albans City",,,230,127,43,0,400
"St. Albans Town",-,"Franklin 3-1",5,1,0,0,6
"St. Albans Town",-,"Franklin 3-2",191,127,9,0,327
"St. George",,,27,22,1,0,50
"St. Johnsbury",,,140,80,10,0,230
Stamford,,,14,11,0,0,25
Stannard,,,9,6,0,0,15
Starksboro,,,91,72,1,0,164
Stockbridge,,,22,9,0,0,31
Stowe,,,68,62,9,0,139
Strafford,,,57,73,0,0,130
Stratton,,,3,4,0,0,7
Sudbury,,,30,17,2,0,49
Sunderland,,,18,10,2,0,30
Sutton,,,13,13,1,0,27
Swanton,,,125,101,47,0,273
Thetford,,,179,140,9,0,328
Tinmouth,,,5,20,2,0,27
Topsham,,,15,16,7,0,38
Townshend,,,35,40,4,0,79
Troy,,,28,19,8,0,55
Tunbridge,,,28,29,3,0,60
Underhill,,,96,104,3,0,203
Vergennes,,,57,38,13,0,108
Vernon,,,32,49,3,0,84
Vershire,,,14,5,3,0,22
Victory,,,2,4,0,0,6
Waitsfield,,,58,49,1,0,108
Walden,,,27,8,2,0,37
Wallingford,,,89,72,1,0,162
Waltham,,,11,11,0,0,22
Wardsboro,,,11,15,0,0,26
Warren,,,64,43,2,0,109
Washington,,,19,16,1,0,36
Waterbury,,,240,212,9,0,461
Waterford,,,18,14,0,0,32
Waterville,,,11,9,0,0,20
Weathersfield,,,82,73,6,0,161
Wells,,,23,11,0,0,34
"W. Fairlee",,,13,20,0,0,33
"W. Haven",,,6,5,0,0,11
"W. Rutland",,,37,38,0,0,75
"W. Windsor",,,25,20,14,0,59
Westfield,,,7,12,7,0,26
Westford,,,61,64,1,0,126
Westminster,,,154,133,6,0,293
Westmore,,,9,6,13,0,28
Weston,,,13,21,0,0,34
Weybridge,,,33,24,1,0,58
Wheelock,,,13,8,0,0,21
Whiting,,,12,6,3,0,21
Whitingham,,,9,18,1,0,28
Williamstown,,,55,45,4,0,104
Williston,-,"Chittenden 5-1",34,48,3,0,85
Williston,-,"Chittenden 5-2",174,167,8,0,349
Wilmington,,,19,40,3,0,62
Windham,,,26,29,2,0,57
Windsor,,,158,99,10,0,267
Winhall,,,10,3,1,0,14
Winooski,-,Armory,80,165,1,0,246
Winooski,-,"St. Francis",100,214,7,0,321
Wolcott,,,27,30,4,0,61
Woodbury,,,36,21,0,0,57
Woodford,,,4,6,1,0,11
Woodstock,,,125,90,11,0,226
Worcester,,,54,36,2,0,92
TOTALS,,,"17,440","16,444","1,533",0,"35,417"
