City/Town,Ward,Pct,"Amos J. Bell",Write-Ins,Blanks,"Total Votes Cast"
,,,
Bloomfield,,,8,0,0,8
Brunswick,,,5,0,0,5
Concord,,,18,0,8,26
Granby,,,2,0,1,3
Guildhall,,,7,0,0,7
Kirby,,,23,2,17,42
Lunenburg,,,25,3,2,30
Maidstone,,,0,0,1,1
Victory,,,2,1,1,4
TOTALS,,,90,6,30,126
