City/Town,Ward,Pct,"Jeb Spaulding","Ed Flanagan",Write-Ins,Blanks,"Total Votes Cast"
,,,,
Addison,,,17,10,0,0,27
Albany,,,21,16,0,0,37
Alburgh,,,73,100,19,0,192
Andover,,,11,8,0,0,19
Arlington,,,43,40,1,0,84
Athens,,,5,20,0,0,25
Bakersfield,,,28,21,0,0,49
Baltimore,,,3,6,0,0,9
Barnard,,,29,12,0,0,41
Barnet,,,23,10,0,0,33
"Barre City",-,"Washington 3-1",149,28,2,0,179
"Barre City",-,"Washington 3-2",109,20,2,0,131
"Barre City",-,"Washington 3-3",26,0,0,0,26
"Barre Town",,,343,59,2,0,404
Barton,-,"Barton Memorial",21,9,0,0,30
Barton,-,"Orleans Memorial",16,8,0,0,24
Belvidere,,,5,3,0,0,8
Bennington,-,"Bennington 2-1",175,96,1,0,272
Bennington,-,"Bennington 2-1 Nb",42,21,1,0,64
Bennington,-,"Bennington 2-2",129,89,5,0,223
Bennington,-,"Bennington 5",1,2,0,0,3
Benson,,,19,10,0,0,29
Berkshire,,,22,13,0,0,35
Berlin,,,113,17,1,0,131
Bethel,,,58,27,0,0,85
Bloomfield,,,3,4,0,0,7
Bolton,,,24,14,0,0,38
Bradford,,,80,77,0,0,157
Braintree,,,58,12,0,0,70
Brandon,,,157,133,0,0,290
Brattleboro,-,"Windham 3-1",235,148,0,0,383
Brattleboro,-,"Windham 3-2",176,185,0,0,361
Brattleboro,-,"Windham 3-3",236,158,2,0,396
Bridgewater,,,27,18,0,0,45
Bridport,,,15,9,0,0,24
Brighton,,,8,14,0,0,22
Bristol,,,103,42,0,0,145
Brookfield,,,97,16,0,0,113
Brookline,,,17,21,0,0,38
Brownington,,,14,8,0,0,22
Brunswick,,,3,2,0,0,5
Burke,,,26,9,0,0,35
Burlington,-,"Chittenden 3-1 Ward 4",238,84,1,0,323
Burlington,-,"Chittenden 3-1 Ward 7",73,54,0,0,127
Burlington,-,"Chittenden 3-2 Ward 2",7,10,0,0,17
Burlington,-,"Chittenden 3-2 Ward 3",9,5,0,0,14
Burlington,-,"Chittenden 3-2 Ward 4",51,18,1,0,70
Burlington,-,"Chittenden 3-2 Ward 7",86,39,0,0,125
Burlington,-,"Chittenden 3-3 Ward 2",28,21,1,0,50
Burlington,-,"Chittenden 3-3 Ward 3",74,72,0,0,146
Burlington,-,"Chittenden 3-3 Ward 5",8,2,0,0,10
Burlington,-,"Chittenden 3-3 Ward 6",9,2,0,0,11
Burlington,-,"Chittenden 3-3 Ward 7",13,9,0,0,22
Burlington,-,"Chittenden 3-4 Ward 1",112,39,1,0,152
Burlington,-,"Chittenden 3-4 Ward 2",35,21,0,0,56
Burlington,-,"Chittenden 3-4 Ward 6",21,8,0,0,29
Burlington,-,"Chittenden 3-5 Ward 5",319,128,0,0,447
Burlington,-,"Chittenden 3-5 Ward 6",259,69,0,0,328
Burlington,-,"Chittenden 3-6 Ward 1",38,19,2,0,59
Cabot,,,41,12,0,0,53
Calais,,,153,26,0,0,179
Cambridge,,,65,24,0,0,89
Canaan,,,10,12,0,0,22
Castleton,,,37,21,0,0,58
Cavendish,,,25,19,0,0,44
Charleston,,,15,9,0,0,24
Charlotte,,,144,33,0,0,177
Chelsea,,,36,13,0,0,49
Chester,,,63,33,0,0,96
Chittenden,,,19,16,0,0,35
Clarendon,,,31,10,0,0,41
Colchester,-,"Chittenden 7-1",104,48,0,0,152
Colchester,-,"Chittenden 7-2",155,42,1,0,198
Concord,,,16,8,0,0,24
Corinth,,,58,22,0,0,80
Cornwall,,,75,14,0,0,89
Coventry,,,5,4,0,0,9
Craftsbury,,,62,18,0,0,80
Danby,,,9,16,0,0,25
Danville,,,43,10,0,0,53
Derby,,,78,60,0,0,138
Dorset,,,24,8,0,0,32
Dover,,,11,20,0,0,31
Dummerston,,,131,101,1,0,233
Duxbury,,,60,13,0,0,73
"E. Haven",,,3,7,0,0,10
"E. Montpelier",,,197,20,0,0,217
Eden,,,10,10,0,0,20
Elmore,,,27,25,0,0,52
Enosburgh,,,43,19,0,0,62
Essex,-,"Chittenden 6-1",98,31,0,0,129
Essex,-,"Chittenden 6-2",156,62,1,0,219
Essex,-,"Chittenden 6-3",41,7,0,0,48
"Fair Haven",,,15,14,0,0,29
Fairfax,,,77,54,0,0,131
Fairfield,,,81,33,1,0,115
Fairlee,,,25,25,0,0,50
Fayston,,,51,12,0,0,63
Ferrisburgh,,,80,24,0,0,104
Fletcher,,,24,8,0,0,32
Franklin,,,45,17,0,0,62
Georgia,,,49,35,0,0,84
Glover,,,29,16,0,0,45
Goshen,,,8,2,0,0,10
Grafton,,,26,27,1,0,54
Granby,,,1,1,0,0,2
"Grand Isle",,,133,140,32,0,305
Granville,,,9,3,0,0,12
Greensboro,,,47,7,0,0,54
Groton,,,19,12,0,0,31
Guildhall,,,3,4,0,0,7
Guilford,,,93,75,0,0,168
Halifax,,,23,20,0,0,43
Hancock,,,3,4,0,0,7
Hardwick,,,162,74,1,0,237
Hartford,-,"Windsor 6-1",80,78,1,0,159
Hartford,-,"Windsor 6-2",281,325,1,0,607
Hartland,,,129,89,2,0,220
Highgate,,,61,28,0,0,89
Hinesburg,-,"Chittenden 1-1",145,49,0,0,194
Hinesburg,-,"Chittenden 1-2",5,1,0,0,6
Holland,,,8,6,0,0,14
Hubbardton,,,9,1,0,0,10
Huntington,,,51,12,0,0,63
"Hyde Park",,,111,39,0,0,150
Ira,-,"Rutland 1-1",5,9,0,0,14
Ira,-,"Rutland 1-2",0,0,0,0,0
Irasburg,,,10,13,1,0,24
"Isle La Motte",,,55,68,12,0,135
Jamaica,,,37,34,0,0,71
Jay,,,7,3,0,0,10
Jericho,,,161,44,0,0,205
Johnson,,,81,38,0,0,119
Killington,,,22,15,0,0,37
Kirby,,,26,13,0,0,39
Landgrove,,,4,0,0,0,4
Leicester,,,31,13,0,0,44
Lemington,,,0,2,0,0,2
Lincoln,,,80,31,0,0,111
Londonderry,,,24,21,0,0,45
Lowell,,,6,18,0,0,24
Ludlow,,,30,22,0,0,52
Lunenburg,,,18,8,0,0,26
Lyndon,,,53,24,0,0,77
Manchester,,,51,28,0,0,79
Marlboro,,,58,55,0,0,113
Marshfield,,,70,21,0,0,91
Mendon,,,18,8,0,0,26
Middlebury,,,199,54,0,0,253
Middlesex,,,146,14,0,0,160
"Middletown Springs",,,23,13,0,0,36
Milton,-,"Chittenden 9",90,54,1,0,145
Milton,-,"Grand Isle-Chittenden 1-1",9,4,2,0,15
Monkton,,,65,20,0,0,85
Montgomery,,,26,11,2,0,39
Montpelier,,,940,101,2,0,"1,043"
Moretown,,,105,18,0,0,123
Morgan,,,11,6,0,0,17
Morristown,,,153,73,0,0,226
"Mount Holly",,,29,22,0,0,51
"Mount Tabor",,,5,4,0,0,9
"New Haven",,,104,66,0,0,170
Newark,,,13,11,0,0,24
Newbury,-,"Center Town House",6,7,0,0,13
Newbury,-,"Town Office",34,29,0,0,63
Newbury,-,"West River Village",19,8,0,0,27
Newfane,,,97,105,3,0,205
"Newport City",,,43,33,1,0,77
"Newport Town",,,5,10,0,0,15
"N. Hero",,,37,30,14,0,81
Northfield,,,207,39,0,0,246
Norton,,,2,7,0,0,9
Norwich,,,319,189,0,0,508
Orange,,,19,2,0,0,21
Orwell,,,28,16,0,0,44
Panton,,,20,7,0,0,27
Pawlet,,,28,15,0,0,43
Peacham,,,45,9,0,0,54
Peru,,,14,8,0,0,22
Pittsfield,,,11,5,0,0,16
Pittsford,,,41,24,0,0,65
Plainfield,,,93,17,0,0,110
Plymouth,,,5,6,0,0,11
Pomfret,,,58,21,0,0,79
Poultney,,,34,19,0,0,53
Pownal,,,38,40,0,0,78
Proctor,,,26,13,0,0,39
Putney,,,155,132,1,0,288
Randolph,,,267,85,0,0,352
Reading,,,8,16,0,0,24
Readsboro,,,23,25,0,0,48
Richford,,,29,32,0,0,61
Richmond,,,174,32,0,0,206
Ripton,,,33,13,0,0,46
Rochester,,,54,23,0,0,77
Rockingham,,,281,292,2,0,575
Roxbury,,,34,4,0,0,38
Royalton,,,170,117,0,0,287
Rupert,,,15,11,0,0,26
"Rutland City",-,"Rutland 5-1",122,65,0,0,187
"Rutland City",-,"Rutland 5-2",58,68,2,0,128
"Rutland City",-,"Rutland 5-3",45,42,0,0,87
"Rutland City",-,"Rutland 5-4",61,51,0,0,112
"Rutland Town",,,115,59,0,0,174
Ryegate,,,27,12,0,0,39
Salisbury,,,36,8,0,0,44
Sandgate,,,4,14,0,0,18
Searsburg,,,2,5,0,0,7
Shaftsbury,,,66,63,0,0,129
Sharon,,,50,32,0,0,82
Sheffield,,,10,3,0,0,13
Shelburne,-,"Chittenden 5-1",203,54,0,0,257
Shelburne,-,"Chittenden 5-2",111,20,1,0,132
Sheldon,,,32,14,1,0,47
Shoreham,,,45,14,0,0,59
Shrewsbury,,,27,15,0,0,42
"S. Burlington",-,"Chittenden 3-10",115,47,0,0,162
"S. Burlington",-,"Chittenden 3-7",177,47,0,0,224
"S. Burlington",-,"Chittenden 3-8",161,42,0,0,203
"S. Burlington",-,"Chittenden 3-9",130,47,2,0,179
"S. Hero",,,159,108,39,0,306
Springfield,-,"Windsor 1-1",9,4,0,0,13
Springfield,-,"Windsor 1-2",606,533,0,0,"1,139"
"St. Albans City",,,215,103,1,0,319
"St. Albans Town",,,133,67,1,0,201
"St. George",,,10,6,0,0,16
"St. Johnsbury",,,87,25,0,0,112
Stamford,,,19,23,0,0,42
Stannard,,,9,5,0,0,14
Starksboro,,,55,25,0,0,80
Stockbridge,,,16,8,0,0,24
Stowe,,,115,15,0,0,130
Strafford,,,71,20,0,0,91
Stratton,,,3,1,0,0,4
Sudbury,,,11,14,0,0,25
Sunderland,,,15,10,0,0,25
Sutton,,,6,6,0,0,12
Swanton,,,175,117,0,0,292
Thetford,,,121,65,0,0,186
Tinmouth,,,29,14,0,0,43
Topsham,,,16,4,0,0,20
Townshend,,,56,60,0,0,116
Troy,,,12,9,0,0,21
Tunbridge,,,69,35,0,0,104
Underhill,,,109,31,0,0,140
Vergennes,,,30,26,0,0,56
Vernon,,,43,35,1,0,79
Vershire,,,30,15,0,0,45
Victory,,,1,2,1,0,4
Waitsfield,,,75,12,0,0,87
Walden,,,23,5,0,0,28
Wallingford,,,52,25,0,0,77
Waltham,,,6,1,0,0,7
Wardsboro,,,27,29,0,0,56
Warren,,,58,20,0,0,78
Washington,,,31,11,0,0,42
Waterbury,,,257,22,0,0,279
Waterford,,,10,6,0,0,16
Waterville,,,10,6,0,0,16
Weathersfield,,,80,64,0,0,144
Wells,,,10,6,0,0,16
"W. Fairlee",,,24,11,0,0,35
"W. Haven",,,5,1,0,0,6
"W. Rutland",,,20,14,1,0,35
"W. Windsor",,,27,15,0,0,42
Westfield,,,6,10,0,0,16
Westford,,,48,11,0,0,59
Westminster,-,"Windham Ward 4",8,13,0,0,21
Westminster,-,"Windham Ward 5",166,186,1,0,353
Westmore,,,8,3,0,0,11
Weston,,,28,10,0,0,38
Weybridge,,,53,5,0,0,58
Wheelock,,,15,2,0,0,17
Whiting,,,8,11,0,0,19
Whitingham,,,20,13,0,0,33
Williamstown,,,53,13,0,0,66
Williston,,,223,67,0,0,290
Wilmington,,,38,32,0,0,70
Windham,,,8,22,0,0,30
Windsor,,,84,91,1,0,176
Winhall,,,9,12,0,0,21
Winooski,,,125,63,0,0,188
Wolcott,,,53,17,0,0,70
Woodbury,,,36,17,0,0,53
Woodford,,,2,5,0,0,7
Woodstock,,,180,99,1,0,280
Worcester,,,72,19,0,0,91
TOTALS,,,"19,090","9,620",178,0,"28,888"
